account|select ACCT_INTRL_ID,ACCT_OPEN_DT,ACCT_STAT_CD,DVP_RVP_FL,LAST_ACTVY_DT,MTHD_ACCT_OPNG,CSTM_1_TX,CSTM_3_TX,ACCT_TYPE1_CD,ALT_ACCT_ID,HH_ACCT_GRP_ID,PRMRY_CUST_INTRL_ID from ofsaafccm.acct
accountaddress|select ACCT_ADDR_SEQ_ID,ADDR_USAGE_CD,ADDR_SEQ_NB,ADDR_CITY_NM,ADDR_CNTRY_CD,ADDR_POSTL_CD,ADDR_RGN_NM,ADDR_STATE_CD,ADDR_STRT_LINE1_TX,ADDR_STRT_LINE2_TX,ADDR_STRT_LINE3_TX,ACCT_INTRL_ID from ofsaafccm.ACCT_ADDR
accountbalance|select ACCT_INTRL_ID,NET_WRTH_AM from ofsaafccm.ACCT_BAL_POSN_SMRY
accountcustomer|select ACCT_INTRL_ID,CUST_INTRL_ID,CUST_ACCT_ROLE_CD from ofsaafccm.CUST_ACCT
accountSSL|select ACCT_INTRL_ID,ACCT_OPEN_DT,ACCT_STAT_CD,DVP_RVP_FL,LAST_ACTVY_DT,MTHD_ACCT_OPNG,CSTM_1_TX,CSTM_3_TX,ACCT_TYPE1_CD,ALT_ACCT_ID,HH_ACCT_GRP_ID,PRMRY_CUST_INTRL_ID from ofsaafccm.acct
advisor|select NVSMT_MGR_INTRL_ID,NVSMT_MGR_NM from ofsaafccm.NVSMT_MGR
advisoraccount|select NVSMT_MGR_INTRL_ID,ACCT_INTRL_ID,MSTR_ACCT_INTRL_ID from ofsaafccm.MANGD_ACCT
bot|select BO_TRXN_INTRL_ID,DBT_CDT_CD,EXCTN_DT,UNRLTD_PARTY_CD,UNIT_QT,TRXN_BASE_AM,PRDCT_TYPE_CD,CSTM_2_TX,CSTM_3_TX,CSTM_4_TX,CSTM_5_TX,TRXN_TYPE1_CD,TRXN_TYPE2_CD,CXL_FL,ACCT_INTRL_ID,CXL_PAIR_TRXN_INTRL_ID,OFFST_ACCT_INTRL_ID,OFFST_ACCTG_RULE_CD,SCRTY_INTRL_ID,MANTAS_TRXN_PURP_CD from ofsaafccm.BACK_OFFICE_TRXN
cash|select TRXN_INTRL_REF_ID,TRXN_EXCTN_DT,CSTM_2_TX,CSTM_3_TX,CSTM_4_TX,CSTM_5_TX,TRXN_BASE_AM,TRXN_TYPE1_CD,TRXN_TYPE2_CD,ACCT_INTRL_ID,CNDTR_ACCT_ID,CNDTR_AUG_NM,MANTAS_TRXN_PURP_CD from ofsaafccm.CASH_TRXN
country|select GEO_CNTRY_CD,GEO_NM from ofsaafccm.GEOGRAPHY
customer|select CUST_INTRL_ID,CUST_ADD_DT,CUST_STAT_CD,BIRTH_DT,CSTM_1_RL,CSTM_1_TX,CSTM_2_TX,CUST_INC_DT,CUST_INDUS_CD,CUST_TYPE_CD,d_date_of_death,FNCL_PRFL_LAST_UPDT_DT,FIRST_NM,MIDL_NM,LAST_NM,OCPTN_NM,ORG_LGL_STRUC_CD,ORG_NM,PRIOR_SAR_FL,PUBLC_PRIVT_CD,WLTH_SRC_DSCR_TX,CTZSHP_CNTRY1_CD,CTZSHP_CNTRY2_CD,HDQ_CTRY,RES_CNTRY_CD,TAXTN_CNTRY_CD,OPR_CTRY from ofsaafccm.CUST
customeraddress|select CUST_ADDR_SEQ_ID,ADDR_USAGE_CD,ADDR_SEQ_NB,ADDR_CITY_NM,ADDR_CNTRY_CD,ADDR_POSTL_CD,ADDR_RGN_NM,ADDR_STATE_CD,ADDR_STRT_LINE1_TX,ADDR_STRT_LINE2_TX,ADDR_STRT_LINE3_TX,CUST_INTRL_ID from ofsaafccm.CUST_ADDR
customercountry|select CUST_INTRL_ID,CNTRY_CD,RLSHP_TYPE_CD from ofsaafccm.CUST_CNTRY
employee|select EMP_INTRL_ID,EMP_TYPE_CD,FIRST_NM,LAST_NM from ofsaafccm.EMP
employeeaccount|select EMP_INTRL_ID,ACCT_INTRL_ID,EMP_ACCT_ROLE_CD from ofsaafccm.EMP_ACCT
mi|select TRXN_INTRL_REF_ID,CSTM_2_TX,CSTM_3_TX,CSTM_4_TX,CSTM_5_TX,INSTR_NB,INSTR_NM,TRXN_BASE_AM,TRXN_ISSUE_DT,TRXN_POST_DT,TRXN_TYPE1_CD,TRXN_TYPE2_CD,REM_ACCT_ID,BENEF_ACCT_ID,BENEF_AUG_NM,REM_AUG_NM,UNKWN_BENEF_FL,UNKWN_REM_FL,INTRL_BENEF_ACCT_FL,INTRL_REM_ACCT_FL,MANTAS_TRXN_PURP_CD from ofsaafccm.MI_TRXN
security|select SCRTY_INTRL_ID,DRVTV_MTRTY_XPRTN_DT,OPTNS_CALL_PUT_CD,PROD_CTGRY_CD,SCRTY_SHRT_NM,BASE_SCRTY_INTRL_ID from ofsaafccm.SCRTY
securitydaily|select SCRTY_INTRL_ID,MKT_CLS_BASE_PR,MKT_DT,OPTNS_STRK_BASE_PR,SCRTY_INTRL_ID from ofsaafccm.SCRTY_MKT_DAILY
trade|select TRADE_INTRL_ID,CUST_OPEN_CLOS_POSN_CD,FIRM_MC_INTRL_ID,LAST_STLMT_DT,LAST_TRADE_BASE_PR,LAST_TRADE_PRNPL_BASE_AM,LAST_TRADE_UNIT_QT,TRADE_DT,TRADE_PURP_CD,LAST_TRADE_BUYER_ACCT_INTRL_ID,LAST_TRADE_SELLR_ACCT_INTRL_ID,PRDCT_CTGRY_CD,SCRTY_INTRL_ID,TRADE_BUYER_ID,TRADE_BUYER_TYPE_CD,TRADE_SELLR_ID,TRADE_SELLR_TYPE_CD from ofsaafccm.TRADE
wire|select TRXN_INTRL_REF_ID,TRXN_EXCTN_DT,CSTM_2_TX,CSTM_3_TX,CSTM_4_TX,CSTM_5_TX,TRXN_BASE_AM,TRXN_TYPE1_CD,TRXN_TYPE2_CD,ORIG_TO_BENEF_INSTR_TX,ORIG_ACCT_ID,BENEF_ACCT_ID,BENEF_AUG_NM,ORIG_AUG_NM,UNKWN_BENEF_FL,UNKWN_ORIG_FL,BENEF_ADDR_PURP_CD,ORIG_ADDR_PURP_CD,INTRL_BENEF_ACCT_FL,INTRL_ORIG_ACCT_FL,MANTAS_TRXN_PURP_CD from ofsaafccm.WIRE_TRXN
KDDreview|SELECT * FROM OFSAAFCCM.KDD_REVIEW
KDDcases|SELECT * FROM OFSAAFCCM.KDD_CASES
KDDbo|SELECT DISTINCT KR.REVIEW_ID,KR.CREAT_TS,A.BO_TRXN_INTRL_ID,A.TRXN_BASE_AM FROM KDD_REVIEW KR,BACK_OFFICE_TRXN_ARC A,KDD_BREAK KB,KDD_BREAK_MTCHS KBM,KDD_DATASET_BASE KDB WHERE KR.REVIEW_ID    = KB.PRNT_BREAK_ID AND KR.REVIEW_TYPE_CD = 'AL' AND KB.BREAK_ID       = KBM.BREAK_ID AND KBM.DATASET_ID    = KDB.DATASET_ID AND KDB.BASE_TABLE    = 'BACK_OFFICE_TRXN' AND KBM.KEY_ID        = A.BO_TRXN_SEQ_ID AND A.TRXN_ISSUE_DT          = KR.CREAT_TS AND A.PRCSNG_BATCH_NM = KR.PRCSNG_BATCH_NM
KDDcash|SELECT DISTINCT KR.REVIEW_ID,KR.CREAT_TS,A.TRXN_INTRL_REF_ID,A.TRXN_BASE_AM FROM KDD_REVIEW KR,CASH_TRXN_ARC A,KDD_BREAK KB,KDD_BREAK_MTCHS KBM,KDD_DATASET_BASE KDB WHERE KR.REVIEW_ID    = KB.PRNT_BREAK_ID AND KR.REVIEW_TYPE_CD = 'AL' AND KB.BREAK_ID       = KBM.BREAK_ID AND KBM.DATASET_ID    = KDB.DATASET_ID AND KDB.BASE_TABLE    = 'CASH_TRXN' AND KBM.KEY_ID        = A.FO_TRXN_SEQ_ID  AND A.PRCSNG_BATCH_NM = KR.PRCSNG_BATCH_NM
KDDmi|SELECT DISTINCT KR.REVIEW_ID,KR.CREAT_TS,A.TRXN_INTRL_REF_ID,A.TRXN_BASE_AM FROM KDD_REVIEW KR,MI_TRXN_ARC A,KDD_BREAK KB,KDD_BREAK_MTCHS KBM,KDD_DATASET_BASE KDB WHERE KR.REVIEW_ID    = KB.PRNT_BREAK_ID AND KR.REVIEW_TYPE_CD = 'AL' AND KB.BREAK_ID       = KBM.BREAK_ID AND KBM.DATASET_ID    = KDB.DATASET_ID AND KDB.BASE_TABLE    = 'MI_TRXN' AND KBM.KEY_ID        = A.FO_TRXN_SEQ_ID  AND A.PRCSNG_BATCH_NM = KR.PRCSNG_BATCH_NM
KDDtrade|SELECT DISTINCT KR.REVIEW_ID, KR.CREAT_TS, TR.TRADE_INTRL_ID,TR.TRADE_SEQ_ID,CASE WHEN KR.CNTRY_ID = 113000063 AND KR.CNTRY_KEY_ID = TR.TRADE_SEQ_ID THEN 'Y' ELSE 'N' END AS FOCUS_FL FROM ofsaafccm.KDD_REVIEW KR, ofsaafccm.TRADE_ARC TR, ofsaafccm.KDD_BREAK KB, ofsaafccm.KDD_BREAK_MTCHS KBM, ofsaafccm.KDD_DATASET_BASE KDB WHERE KR.REVIEW_ID = KB.PRNT_BREAK_ID AND KR.REVIEW_TYPE_CD = 'AL' AND KB.BREAK_ID = KBM.BREAK_ID AND KBM.DATASET_ID = KDB.DATASET_ID AND KDB.BASE_TABLE = 'TRADE' AND KBM.KEY_ID = TR.TRADE_SEQ_ID AND TR.ARC_DT = KR.CREAT_TS AND TR.ARC_BATCH_NM = KR.PRCSNG_BATCH_NM
KDDwire|SELECT DISTINCT KR.REVIEW_ID,KR.CREAT_TS,A.TRXN_INTRL_REF_ID,A.TRXN_BASE_AM FROM KDD_REVIEW KR,WIRE_TRXN_ARC A,KDD_BREAK KB,KDD_BREAK_MTCHS KBM,KDD_DATASET_BASE KDB WHERE KR.REVIEW_ID    = KB.PRNT_BREAK_ID AND KR.REVIEW_TYPE_CD = 'AL' AND KB.BREAK_ID       = KBM.BREAK_ID AND KBM.DATASET_ID    = KDB.DATASET_ID AND KDB.BASE_TABLE    = 'WIRE_TRXN' AND KBM.KEY_ID        = A.FO_TRXN_SEQ_ID AND A.PRCSNG_BATCH_NM = KR.PRCSNG_BATCH_NM



KDDreview|SELECT review_id,scnro_id,scnro_displ_nm,cntry_key_id,FOCAL_NTITY_DSPLY_NM,FOCAL_NTITY_DSPLY_id,hilgt_tx FROM OFSAAFCCM.KDD_REVIEW
KDDTObo|SELECT review_id,trxn_intrl_ref_id FROM ofsaafccm.kdd_alert_mtch_bo_trxn_vw

boPurpose|select BO_TRXN_INTRL_ID,mantas_trxn_purp_cd FROM ofsaafccm.BACK_OFFICE_TRXN
miPurpose|select TRXN_INTRL_REF_ID,mantas_trxn_purp_cd FROM ofsaafccm.MI_TRXN
wirePurpose|select TRXN_INTRL_REF_ID,mantas_trxn_purp_cd FROM ofsaafccm.WIRE_TRXN
cashPurpose|select TRXN_INTRL_REF_ID,mantas_trxn_purp_cd FROM ofsaafccm.CASH_TRXN


KDDmi|select REVIEW_ID,TRXN_INTRL_REF_ID FROM OFSAAFCCM.KDD_ALERT_MTCH_MI_TRXN_VW
KDDwire|select REVIEW_ID,TRXN_INTRL_REF_ID FROM OFSAAFCCM.KDD_ALERT_MTCH_WIRE_TRXN_VW
KDDcash|select REVIEW_ID,TRXN_INTRL_REF_ID FROM OFSAAFCCM.KDD_ALERT_MTCH_CASH_TRXN_VW
